                                                       
###############################
#                 .           #
#         @@@                 ##############
#         @+@                              #
#         @@@         #############        #
############          #           #        #
           #     .    #           #        #
           #          #############        #
           #                               #
           ####################### #########
                                 # #
                                 # #
                                 # #
                                 # ####################
                                 #                    #
####################################################  #
#                                            #     #  #
#                                            #  #  #  #
#                                               #     #
#######################################################